************************
*           *          *
* **** **** * * ****** *
* *  ***  * * * *      *
*    * *  *   * * ******
* **** *  * *** *      *
*      *  *  *  *  *   *
********  *  *     *   *
*               *      *
************************
